Babydoll set in pastel pink with floral embroidery lingerie: 淡粉色花卉刺绣娃娃装套装
Beaded Mesh Teddy lingerie: 钉珠网纱泰迪内衣
Black latex waist cincher with matching pasties lingerie: 黑色乳胶束腰配同款乳贴
Bridal lingerie set with pearls and lace lingerie: 珍珠蕾丝新娘内衣套装
Butterfly themed sheer bra and split skirt lingerie: 蝴蝶主题透明文胸与开衩短裙套装
Caged Lace Teddy lingerie: 笼式蕾丝泰迪内衣
Caged Underbust Corset lingerie: 笼式下胸束身衣
Classic black lace bralette with matching high-waisted panties lingerie: 经典黑色蕾丝法式内衣配同款高腰内裤
Cobalt blue sheer panel chemise lingerie: 钴蓝色透明拼接衬裙
Contrast lace paneling teddy in black and white lingerie: 黑白撞色蕾丝拼接泰迪内衣
Convertible Strapless Bra lingerie: 可转换无肩带文胸
Corded Lace Teddy lingerie: 绳编蕾丝泰迪内衣
Cotton Blend Wireless Bra lingerie: 棉混纺无钢圈文胸
Cotton Ribbed Bralette lingerie: 棉质罗纹法式内衣
Cotton Ruffle Bralette lingerie: 棉质荷叶边法式内衣
Cotton Soft Cup Bra lingerie: 棉质软杯文胸
Crochet Halter Bralette lingerie: 钩针挂脖法式内衣
Crochet Lace Bralette lingerie: 钩针蕾丝法式内衣
Crochet lace halter neck teddy lingerie: 钩针蕾丝挂脖泰迪内衣
Crochet Lace Panty lingerie: 钩针蕾丝内裤
Crochet Trim Bra lingerie: 钩针饰边文胸
Crochet Trim Chemise lingerie: 钩针饰边衬裙
Cross-Back Bikini Top lingerie: 交叉后背比基尼上衣
Cut-Out Back Teddy lingerie: 露背泰迪内衣
Cut-Out Detail Bra lingerie: 镂空细节文胸
Cut-Out Lace Bodysuit lingerie: 镂空蕾丝连体紧身衣
Cutout Lace Bralette lingerie: 镂空蕾丝法式内衣
Cut-Out Mesh Bodysuit lingerie: 镂空网纱连体紧身衣
Cut-out panels monokini-style bodysuit lingerie: 镂空拼接一片式连体紧身衣
Cut-Out Sheer Teddy lingerie: 镂空透明泰迪内衣
Deep blue velvet bodysuit with a plunging neckline lingerie: 深蓝色天鹅绒深V领连体紧身衣
Deep plunge lace-up back teddy in satin lingerie: 缎面深V后背系带泰迪内衣
Draped Satin Corset Top lingerie: 垂褶缎面束身上衣
Egyptian inspired gold bra and sheer draping skirt lingerie: 埃及风金色文胸与透明垂感半裙套装
Elegant longline bra and tap pant set in ivory lingerie: 雅致象牙白长款文胸与tap短裤套装
Embellished bustier with rhinestone detailing lingerie: 水钻细节镶饰紧身胸衣
Embellished Mesh Gown lingerie: 镶饰网纱睡袍
Embroidered Cup Bustier lingerie: 刺绣罩杯紧身胸衣
Embroidered High Waist Brief lingerie: 刺绣高腰三角裤
Embroidered Lace Corset lingerie: 刺绣蕾丝束身衣
Embroidered Longline Bra lingerie: 刺绣长款文胸
Embroidered Mesh Chemise lingerie: 刺绣网纱衬裙
Embroidered Mesh Panty lingerie: 刺绣网纱内裤
Embroidered Mesh Teddy lingerie: 刺绣网纱泰迪内衣
Embroidered Silk Bralette lingerie: 刺绣真丝法式内衣
Embroidered Strapless Bra lingerie: 刺绣无肩带文胸
Embroidered Tulle Bodysuit lingerie: 刺绣薄纱连体紧身衣
Embroidered Velvet Teddy lingerie: 刺绣天鹅绒泰迪内衣
Eyelash Lace Gown lingerie: 睫毛蕾丝睡袍
Faux Fur Trim Robe lingerie: 人造毛皮饰边睡袍
Faux leather plunge bodysuit with studs lingerie: 仿皮铆钉深V连体紧身衣
Faux Leather Thong lingerie: 仿皮丁字裤
Faux Suede Bodysuit lingerie: 仿麂皮连体紧身衣
Feather Accented Babydoll lingerie: 羽毛点缀娃娃装
Fishnet bodystocking with cutouts lingerie: 镂空渔网连体袜
Fishnet Floral Triangle Teddy lingerie: 渔网花卉三角杯泰迪内衣
Fishnet Halter Bodystocking lingerie: 渔网挂脖连体袜
Fishnet Strappy Teddy lingerie: 渔网绑带泰迪内衣
Floral Applique Teddy lingerie: 花卉贴饰泰迪内衣
Floral Embroidered Bodystocking lingerie: 花卉刺绣连体袜
Floral Lace Corset lingerie: 花卉蕾丝束身衣
Floral Lace G-String lingerie: 花卉蕾丝丁字裤
Floral lace kimono with a silk tie waist lingerie: 花卉蕾丝和服式外袍配真丝腰带
Floral Lace Slip lingerie: 花卉蕾丝衬裙
Floral Print Balconette Bra lingerie: 花卉印花半罩杯文胸
Floral Print Chemise lingerie: 花卉印花衬裙
Floral Trim Bra lingerie: 花卉饰边文胸
Fringe Detail Chemise lingerie: 流苏细节衬裙
Fringe Lace Teddy lingerie: 流苏蕾丝泰迪内衣
Fringed silk bra top and high-waist panties lingerie: 流苏真丝文胸上衣与高腰内裤套装
Front Closure Lace Bra lingerie: 前扣蕾丝文胸
Gauze Babydoll Dress lingerie: 薄纱娃娃裙式内衣
Glitter Mesh Teddy lingerie: 闪光网纱泰迪内衣
Glitter Trim Corset lingerie: 闪光饰边束身衣
Halter Plunge Crotchless Teddy lingerie: 挂脖深V开裆泰迪内衣
High Impact Convertible Bra lingerie: 高强度可转换文胸
High Neck Lace Bralette lingerie: 高领蕾丝法式内衣
High neck mesh bodice with lace panels lingerie: 高领网纱蕾丝拼接衣身
High Waist Satin Brief lingerie: 高腰缎面三角裤
High-gloss PVC catsuit with front zipper lingerie: 高光PVC前拉链连体衣
High-Leg Lace Brief lingerie: 高开衩蕾丝三角裤
High-Waist Shaping Thong lingerie: 高腰塑形丁字裤
High-Waisted Lace Panty Set lingerie: 高腰蕾丝内裤套装
Houndstooth Print Garter Belt lingerie: 千鸟格印花吊袜带
Jacquard print underbust corset with lace-up back lingerie: 提花印花后系带下胸束身衣
Jersey Knit Bikini Brief lingerie: 针织比基尼三角裤
Jersey Knit Thong lingerie: 针织丁字裤
Jersey Lace-Up Chemise lingerie: 针织系带衬裙
Jersey Wrap Robe lingerie: 针织裹身睡袍
Keyhole front halter bodysuit in shimmering fabric lingerie: 闪光面料钥匙孔前襟挂脖连体紧身衣
Knit Jersey Slip Dress lingerie: 针织衬裙式连衣裙
Knit Lace Garter Belt lingerie: 针织蕾丝吊袜带
Lace and leather mixed fabric bodysuit with zippers lingerie: 蕾丝皮革拼接拉链连体紧身衣
Lace and Pearl Thong lingerie: 蕾丝珍珠丁字裤
Lace and Velvet Corset lingerie: 蕾丝天鹅绒束身衣
Lace Bodice Nightgown lingerie: 蕾丝衣身睡裙
Lace Cap Sleeve Teddy lingerie: 蕾丝盖袖泰迪内衣
Lace Detail Slip Dress lingerie: 蕾丝细节衬裙式连衣裙
Lace Edged Thong lingerie: 蕾丝镶边丁字裤
Lace Embellished Bustier lingerie: 蕾丝镶饰紧身胸衣
Lace Full Coverage Bra lingerie: 蕾丝全罩杯文胸
Lace Halter Plunge Teddy lingerie: 蕾丝挂脖深V泰迪内衣
Lace High-Neck Teddy lingerie: 蕾丝高领泰迪内衣
Lace Inset Slip lingerie: 蕾丝嵌入衬裙
Lace Overlay Corset lingerie: 蕾丝覆面束身衣
Lace Overlay Panty lingerie: 蕾丝覆面内裤
Lace Trim Cycling Shorts lingerie: 蕾丝饰边单车短裤式内裤
Lace Trim Maternity Bra lingerie: 蕾丝饰边孕妇文胸
Lace Trim Silk Bodysuit lingerie: 蕾丝饰边真丝连体紧身衣
Lace Trimmed Bodysuit lingerie: 蕾丝饰边连体紧身衣
Lace Trimmed Robe lingerie: 蕾丝饰边睡袍
Lace Trimmed Silk Shorts lingerie: 蕾丝饰边真丝短裤
Lace Wing Push-Up Bra lingerie: 蕾丝侧翼聚拢文胸
Lace-Up Front Corset lingerie: 前系带束身衣
Lace-Up Leather Teddy lingerie: 系带皮革泰迪内衣
Lace-Up Satin Corset lingerie: 系带缎面束身衣
Leather and Lace Bustier lingerie: 皮革蕾丝紧身胸衣
Leather and Mesh Bodysuit lingerie: 皮革网纱连体紧身衣
Leather Buckle Corset lingerie: 皮革搭扣束身衣
Leather Halter Bodysuit lingerie: 皮革挂脖连体紧身衣
Leather Paneled Bralette lingerie: 皮革拼接法式内衣
Leatherette Strapless Bra lingerie: 仿皮无肩带文胸
Leopard Print Bikini Brief lingerie: 豹纹比基尼三角裤
Leopard print teddy with black lace details lingerie: 豹纹印花缀黑色蕾丝细节泰迪内衣
Lightly lined underwire cup teddy with floral print lingerie: 花卉印花薄衬钢圈杯泰迪内衣
Lurex Detail G-String lingerie: 金银丝细节丁字裤
Luxurious marabou robe over a satin slip lingerie: 奢华鸵鸟毛睡袍内搭缎面衬裙
Mesh Back Bikini Brief lingerie: 网纱后背比基尼三角裤
Mesh Cutout Bra lingerie: 网纱镂空文胸
Mesh Layered Teddy lingerie: 网纱层叠泰迪内衣
Mesh Overlay Bralette lingerie: 网纱覆面法式内衣
Mesh Panel Corset lingerie: 网纱拼接束身衣
Mesh Paneled Bodysuit lingerie: 网纱拼接连体紧身衣
Mesh Ruffle Chemise lingerie: 网纱荷叶边衬裙
Mesh Trimmed Teddy lingerie: 网纱饰边泰迪内衣
Metallic Detail Babydoll lingerie: 金属细节娃娃装
Metallic gold bikini top and micro mini skirt lingerie: 金属金色比基尼上衣与超短迷你裙套装
Metallic Lace Babydoll lingerie: 金属蕾丝娃娃装
Metallic Lace Teddy lingerie: 金属蕾丝泰迪内衣
Metallic Trim Teddy lingerie: 金属饰边泰迪内衣
Microfiber Boxer Brief lingerie: 超细纤维平角内裤
Mixed mesh and lace panel long sleeve bodysuit lingerie: 网纱蕾丝拼接长袖连体紧身衣
Modal Lounge Bodysuit lingerie: 莫代尔家居连体紧身衣
Multi-strap halter bra and g-string with chains lingerie: 多绑带挂脖文胸与链条丁字裤套装
Neon Lace Babydoll lingerie: 荧光蕾丝娃娃装
Neon mesh cutout bodysuit with glowing effects under black light lingerie: 荧光网纱镂空黑光效果连体紧身衣
Neon pink triangle bralette and boyshorts lingerie: 荧光粉三角杯法式内衣与平角短裤套装
Neon Trim Bikini Brief lingerie: 荧光饰边比基尼三角裤
Neoprene Cutout Bralette lingerie: 氯丁橡胶镂空法式内衣
Neoprene Strappy Bra lingerie: 氯丁橡胶绑带文胸
Neoprene Zip Bra lingerie: 氯丁橡胶拉链文胸
Peek-a-boo cup bra and crotchless panty lingerie: 开孔罩杯文胸与开裆内裤套装
Peekaboo Cup Teddy lingerie: 开孔罩杯泰迪内衣
Pin-up style polka dot bra and high-waist panties lingerie: 复古招贴画风波点文胸与高腰内裤套装
Pleated Babydoll Set lingerie: 百褶娃娃装套装
Plunge Backless Bodysuit lingerie: 深V露背连体紧身衣
Plush Velvet Robe lingerie: 长毛绒天鹅绒睡袍
Polka Dot Push-Up Bra lingerie: 波点聚拢文胸
Polka Dot Tanga Brief lingerie: 波点Tanga三角裤
Printed Microfiber Brief lingerie: 印花超细纤维三角裤
Racerback Sports Bra lingerie: 工字背运动文胸
Red silk chemise with delicate lace trim lingerie: 红色真丝衬裙饰精致蕾丝边
Red velvet corset with a matching mini cape lingerie: 红色天鹅绒束身衣配同款迷你披肩
Rhinestone Garter Belt lingerie: 水钻吊袜带
Rhinestone Studded Teddy lingerie: 镶水钻泰迪内衣
Rhinestone Trim Bra lingerie: 水钻饰边文胸
Ribbed Cotton Bodysuit lingerie: 罗纹棉连体紧身衣
Ribbed Seamless Thong lingerie: 罗纹无缝丁字裤
Romantic off-shoulder lace boudoir dress lingerie: 浪漫露肩蕾丝闺房连衣裙
Ruched Mesh Bodysuit lingerie: 褶皱网纱连体紧身衣
Ruffle Edge Teddy lingerie: 荷叶边泰迪内衣
Ruffled Cotton Chemise lingerie: 荷叶边棉质衬裙
Ruffled Hem Chemise lingerie: 荷叶边下摆衬裙
Ruffled Lace Boyshorts lingerie: 荷叶边蕾丝平角短裤
Ruffled Mesh Teddy lingerie: 荷叶边网纱泰迪内衣
Satin and Lace Robe Set lingerie: 缎面蕾丝睡袍套装
Satin and Lace Slip lingerie: 缎面蕾丝衬裙
Satin Bow-Tie Teddy lingerie: 缎面蝴蝶结泰迪内衣
Satin Chemise with Lace Trim lingerie: 缎面蕾丝饰边衬裙
Satin Crossover Bralette lingerie: 缎面交叉法式内衣
Satin Edge Boyshorts lingerie: 缎面镶边平角短裤
Satin Embroidered Bralette lingerie: 缎面刺绣法式内衣
Satin Lace-Up Panty lingerie: 缎面系带内裤
Satin Paneled Bralette lingerie: 缎面拼接法式内衣
Satin Peplum Corset lingerie: 缎面荷叶腰摆束身衣
Satin Ruched Bustier lingerie: 缎面褶皱紧身胸衣
Satin Ruffle Bralette lingerie: 缎面荷叶边法式内衣
Satin Scoop Bodysuit lingerie: 缎面U领连体紧身衣
Satin slip nightgown with side slits and lace cups lingerie: 缎面侧开衩蕾丝罩杯吊带睡裙
Satin Trim Lace Bodysuit lingerie: 缎面饰边蕾丝连体紧身衣
Scallop edge lace wraparound bralette and panty lingerie: 扇贝边蕾丝裹身法式内衣与内裤套装
Scalloped Lace Bra lingerie: 扇贝边蕾丝文胸
Scoop Neck Camisole Bra lingerie: U领吊带式文胸
Sculpted Push-Up Bra lingerie: 塑形聚拢文胸
Seamless Sport Thong lingerie: 无缝运动丁字裤
Seamless Strappy Thong Bodysuit lingerie: 无缝绑带丁字裤连体紧身衣
See-through chiffon full-length nightgown lingerie: 透明雪纺及地睡裙
Sequin Detail Corset lingerie: 亮片细节束身衣
Sequined bra top with high-waist lace briefs lingerie: 亮片文胸上衣配高腰蕾丝三角裤
Sequined Bralette lingerie: 亮片法式内衣
Sheer Caged Bodysuit lingerie: 透明笼式连体紧身衣
Sheer Cutout Chemise lingerie: 透明镂空衬裙
Sheer Dot Mesh Bodysuit lingerie: 透明波点网纱连体紧身衣
Sheer embroidered cape with matching thong lingerie: 透明刺绣披肩配同款丁字裤
Sheer Embroidered Garter Belt lingerie: 透明刺绣吊袜带
Sheer Embroidered Thong lingerie: 透明刺绣丁字裤
Sheer Floral Chemise lingerie: 透明花卉衬裙
Sheer Lace Bustier lingerie: 透明蕾丝紧身胸衣
Sheer Lace Chemise lingerie: 透明蕾丝衬裙
Sheer Lace Garter Belt lingerie: 透明蕾丝吊袜带
Sheer Long Sleeve Bodystocking lingerie: 透明长袖连体袜
Sheer Marabou Babydoll lingerie: 透明鸵鸟毛娃娃装
Sheer mesh bodysuit with strategically placed embroidery lingerie: 特定位置刺绣透明网纱连体紧身衣
Sheer Mesh Garter Belt lingerie: 透明网纱吊袜带
Sheer Mesh Nightgown lingerie: 透明网纱睡裙
Sheer Panel Bustier lingerie: 透明拼接紧身胸衣
Sheer Polka Dot Babydoll lingerie: 透明波点娃娃装
Sheer Ruffle Corset lingerie: 透明荷叶边束身衣
Sheer Slip Dress lingerie: 透明吊带连衣裙
Sheer Tulle Bodysuit lingerie: 透明薄纱连体紧身衣
Sheer tulle peignoir with feather trim lingerie: 透明薄纱羽毛饰边晨袍
Silk Balconette Bra lingerie: 真丝半罩杯文胸
Silk Blend Control Briefs lingerie: 真丝混纺塑形三角裤
Silk charmeuse pajama set with piping details lingerie: 真丝光泽绸缎滚边睡衣套装
Silk Kimono Robe lingerie: 真丝和服式睡袍
Silk Sleep Chemise lingerie: 真丝睡眠衬裙
Silk Tie Bralette lingerie: 真丝系带法式内衣
Silk Wrap Teddy lingerie: 真丝裹身泰迪内衣
Soft jersey lounge set with lace insets lingerie: 柔软针织蕾丝拼接家居套装
Sporty bralette and high-waist shorts in stretch cotton lingerie: 运动风法式内衣与弹力棉高腰短裤套装
Strap Detail Thong lingerie: 绑带细节丁字裤
Strapless Bustier Set lingerie: 无肩带紧身胸衣套装
Strappy Back Brief lingerie: 后背绑带三角裤
Strappy black cage bra and matching thong lingerie: 绑带黑色笼式文胸与同款丁字裤套装
Strappy Halter Bra lingerie: 绑带挂脖文胸
Strappy Lace Panties lingerie: 绑带蕾丝内裤
Strappy Lace-Up Teddy lingerie: 绑带系带泰迪内衣
Strappy Mesh Bodysuit lingerie: 绑带网纱连体紧身衣
Strappy Satin Teddy lingerie: 绑带缎面泰迪内衣
Stretch Lace Halter Bralette lingerie: 弹力蕾丝挂脖法式内衣
Stretch lace off-shoulder top with miniskirt lingerie: 弹力蕾丝露肩上衣配迷你裙套装
Stretch Satin Garter Belt lingerie: 弹力缎面吊袜带
Stretch Silk Bralette lingerie: 弹力真丝法式内衣
Stretch Velvet Bodysuit lingerie: 弹力天鹅绒连体紧身衣
Striped Mesh Teddy lingerie: 条纹网纱泰迪内衣
Tie-Back Halter Bra lingerie: 后系带挂脖文胸
Tulle Peplum Bustier lingerie: 薄纱荷叶腰摆紧身胸衣
Tulle Ruffle Bralette lingerie: 薄纱荷叶边法式内衣
Tulle Skirted Thong lingerie: 薄纱裙式丁字裤
Unlined Lace Apron Babydoll Set lingerie: 无衬里蕾丝围裙式娃娃装套装
Velour Lounge Set lingerie: 丝绒家居套装
Velvet and Lace Teddy lingerie: 天鹅绒蕾丝泰迪内衣
Velvet Applique Bralette lingerie: 天鹅绒贴饰法式内衣
Velvet Banded Bra lingerie: 天鹅绒宽边文胸
Velvet Cut-Out Bodysuit lingerie: 天鹅绒镂空连体紧身衣
Velvet Fringe Bodysuit lingerie: 天鹅绒流苏连体紧身衣
Velvet Halter Bralette lingerie: 天鹅绒挂脖法式内衣
Velvet High Waist Panty lingerie: 天鹅绒高腰内裤
Velvet Lace-Up Bustier lingerie: 天鹅绒系带紧身胸衣
Velvet Lounge Shorts lingerie: 天鹅绒家居短裤
Velvet Paneled Bralette lingerie: 天鹅绒拼接法式内衣
Velvet Strappy Bra lingerie: 天鹅绒绑带文胸
Velvet Trim Babydoll lingerie: 天鹅绒饰边娃娃装
Velvet Trim Corset lingerie: 天鹅绒饰边束身衣
Vintage-inspired high-waisted briefs and bra set with polka dots lingerie: 复古风高腰三角裤与波点文胸套装
White satin corset with garter belts and sheer stockings lingerie: 白色缎面束身衣配吊袜带与透明长筒袜
Zip Detail Sports Bra lingerie: 拉链细节运动文胸
Zip-Front Sports Bra lingerie: 前拉链运动文胸