T-Shirt : T恤
Tank Top : 背心
Vest : 马甲
Overcoat : 大衣
Trench Coat : 风衣
Denim Jacket : 牛仔夹克
Leather Jacket : 皮夹克
Blazer : 西装式休闲外套
Suit Jacket : 西服上衣
Peacoat : 海军呢大衣
Hoodie : 连帽卫衣
Sweater : 毛衣
Cardigan : 开衫毛衣
Polo Shirt : 马球衫
Flannel Shirt : 法兰绒衬衫
Oxford Shirt : 牛津纺衬衫
Henley Shirt : 亨利衫
Bomber Jacket : 飞行员夹克
Parka : 派克大衣
Anorak : 套头风衣
Windbreaker : 防风衣
Harrington Jacket : 哈灵顿夹克
Chore Coat : 工装夹克
Duffle Coat : 牛角扣大衣
Gilet : 填充马甲
Quilted Jacket : 绗缝夹克
Track Jacket : 运动外套
Rugby Shirt : 橄榄球衫
Turtleneck : 高领衫
Puffer Jacket : 羽绒服
Waxed Jacket : 英式涂蜡夹克
Corduroy Jacket : 灯芯绒夹克
Linen Shirt : 亚麻衬衫
Seersucker Shirt : 泡泡纱衬衫
Band Collar Shirt : 立领衬衫
Norfolk Jacket : 英式诺福克夹克
Chesterfield Coat : 英式切斯特菲尔德大衣
Loden Coat : 奥地利式罗登呢大衣
Nehru Jacket : 印度式尼赫鲁夹克
Sherwani : 印度式谢尔瓦尼
Barong Tagalog : 菲律宾式巴隆他加禄
Guayabera : 拉美式瓜亚贝拉衬衫
Dashiki : 西非式达西奇
Kurta : 印度式库尔塔
Bush Shirt : 狩猎衬衫
Redingote : 法式瑞丁格特外套
Smoking Jacket : 天鹅绒吸烟夹克
Doublet : 欧式多布莱特短上衣
Noragi : 日式野良着
Haori : 日式羽织
Jinbei : 日式甚平
Bolero Jacket : 西班牙式波莱罗短外套
Montgomery Coat : 英式蒙哥马利大衣
Ulster Coat : 爱尔兰式阿尔斯特大衣
Spencer Jacket : 英式斯宾塞短外套
Chamois Shirt : 阿尔卑斯式麂皮绒衬衫
Lederhosen Jacket : 德式传统夹克
Mandarin Jacket : 中式立领夹克
Kaftan : 中东式卡夫坦长衫
Frock Coat : 维多利亚式双排扣长礼服
Zoot Suit Jacket : 美式佐特西装夹克
Varsity Jacket : 美式棒球夹克
Coach Jacket : 尼龙教练夹克
Flight Jacket : MA-1飞行夹克
M65 Field Jacket : M65野战夹克
Tunic Shirt : 中世纪式束腰长衬衫
Kilt Jacket : 苏格兰式短裙夹克
Sou'wester : 渔夫防水外套
Agbada : 西非式阿格巴达
Boubou : 西非式布布服
Charro Jacket : 墨西哥式查罗夹克
Dishdasha : 阿拉伯式迪什达沙
Fermen : 巴尔干式费尔门背心
Ghillie Shirt : 苏格兰式吉利衬衫
Gho : 不丹式帼
Jelek : 东南欧式杰莱克背心
Jeogori : 韩式赤古里
Korowai : 毛利式科罗威斗篷
Native American Ribbon Shirt : 美国原住民式缎带衬衫
Prince Charlie Jacket : 苏格兰式查理王子夹克
Thawb : 阿拉伯式索布长袍
Trachten Jacket : 日耳曼式特拉赫滕夹克
Gakti : 萨米人式加克蒂束腰外衣
Tyrolean Jacket : 蒂罗尔式夹克
Xhamadani : 阿尔巴尼亚式哈马达尼背心
Xhurdia : 阿尔巴尼亚式胡尔迪亚外套
Yeleko : 希腊式耶莱科背心
Changshan : 中式长衫
Kosovorotka : 俄式科索沃罗特卡衬衫
Shuka : 马赛人式舒卡披巾
Aloha Shirt : 夏威夷式阿罗哈衬衫
Button-Down Shirt : 纽扣衬衫
Crew Neck Shirt : 圆领衬衫
V-Neck Shirt : V领衬衫
Mock Neck Shirt : 假高领衬衫
Zip-Up Hoodie : 拉链连帽衫
Pullover Hoodie : 套头连帽衫
Fleece Jacket : 抓绒外套
Softshell Jacket : 软壳外套
Hardshell Jacket : 硬壳外套
Down Jacket : 羽绒夹克
Rain Jacket : 雨衣
Thermal Shirt : 保暖衬衫
Compression Shirt : 压缩衬衫
Athletic Shirt : 运动衬衫
Workout Tank : 健身背心
Jersey : 运动球衣
Cycling Jersey : 骑行衫
Running Shirt : 跑步衫
Golf Shirt : 高尔夫衫
Tennis Shirt : 网球衫
Fishing Shirt : 钓鱼衬衫
Hunting Shirt : 狩猎衬衫
Tactical Shirt : 战术衬衫
Work Shirt : 工作衬衫
Uniform Shirt : 制服衬衫
Dress Shirt : 正装衬衫
Business Shirt : 商务衬衫
Evening Shirt : 晚礼服衬衫
Tuxedo Shirt : 燕尾服衬衫
Dinner Jacket : 晚餐夹克
Morning Coat : 晨礼服
Tailcoat : 燕尾服
Sport Coat : 运动外套
Double-Breasted Blazer : 双排扣西装外套
Single-Breasted Blazer : 单排扣西装外套
Pinstripe Jacket : 细条纹夹克
Tweed Jacket : 粗花呢夹克
Wool Jacket : 羊毛夹克
Cotton Jacket : 棉质夹克
Silk Jacket : 丝质夹克
Velvet Jacket : 天鹅绒夹克
Cashmere Jacket : 羊绒夹克
Suede Jacket : 绒面革夹克
Shearling Jacket : 羊毛皮夹克
Reversible Jacket : 双面夹克
Cropped Jacket : 短款夹克
Oversized Jacket : 宽松夹克
Fitted Jacket : 合身夹克
Slim Fit Jacket : 修身夹克
Vintage Jacket : 复古夹克
Classic Jacket : 经典夹克
Modern Jacket : 现代夹克
Minimalist Jacket : 简约夹克
Deconstructed Jacket : 解构夹克
Collarless Jacket : 无领夹克
Shawl Collar Jacket : 披肩领夹克
Peak Lapel Jacket : 戟驳领夹克
Notch Lapel Jacket : 平驳领夹克
French Cuff Shirt : 法式袖口衬衫
Short Sleeve Shirt : 短袖衬衫
Long Sleeve Shirt : 长袖衬衫
Raglan Sleeve Shirt : 插肩袖衬衫
Bell Sleeve Shirt : 喇叭袖衬衫
Sleeveless Shirt : 无袖衬衫
Undershirt : 内衣
Thermal Underwear : 保暖内衣
Moisture-Wicking Shirt : 速干衬衫
Anti-Odor Shirt : 防臭衬衫
Bamboo Shirt : 竹纤维衬衫
Merino Wool Shirt : 美利奴羊毛衬衫
Organic Cotton Shirt : 有机棉衬衫
Hemp Shirt : 大麻纤维衬衫
Custom Shirt : 定制衬衫
Embroidered Shirt : 刺绣衬衫
Printed Shirt : 印花衬衫
Tie-Dye Shirt : 扎染衬衫
Striped Shirt : 条纹衬衫
Plaid Shirt : 格子衬衫
Polka Dot Shirt : 波点衬衫
Solid Color Shirt : 纯色衬衫
Graphic Shirt : 图形衬衫
Logo Shirt : 标志衬衫